33,95,95,7,67,14,99,20,97,97,100,14,101,109,14,14,66,8,9,95,95,7,67,20,100,59,45,95,43,70,20,20,113,108,21,95,95,95,95,95
45,95,7,67,14,110,20,100,20,14,112,20,14,14,109,20,109,96,66,8,8,67,112,14,99,66,8,9,95,31,55,20,14,14,66,8,8,9,95,95
9,7,67,110,98,54,71,32,55,96,98,20,109,20,14,20,113,113,98,109,109,20,20,98,97,110,14,66,8,8,67,99,96,14,112,20,99,66,8,8
66,67,20,14,54,33,30,95,19,111,20,109,101,20,14,14,96,20,14,101,14,110,100,108,96,96,98,111,98,20,20,101,20,108,20,108,99,20,109,14
96,54,32,32,47,95,6,7,67,14,14,112,14,110,101,54,32,55,101,14,98,14,14,99,109,20,20,100,96,14,14,14,99,100,54,55,109,97,54,55
112,21,95,43,78,8,58,67,14,20,100,111,14,96,54,33,95,22,55,14,113,99,14,14,14,54,32,71,55,100,108,100,112,54,33,31,32,32,47,19
32,33,95,43,46,32,32,55,14,96,108,20,100,108,66,9,95,18,19,98,109,112,111,14,109,21,95,30,31,55,20,97,111,66,8,8,9,95,34,67
95,95,95,95,95,7,8,67,14,20,20,97,109,108,97,66,8,58,67,20,112,14,110,96,96,21,6,95,95,19,20,14,113,113,109,20,66,8,67,100
8,9,95,95,7,67,100,97,20,101,110,110,14,96,108,112,97,20,54,71,71,55,20,112,20,66,58,8,8,67,113,20,108,97,20,112,97,14,20,99
110,66,8,8,67,98,99,20,100,109,108,112,98,113,111,20,96,14,21,30,30,31,55,20,14,14,109,54,32,55,99,100,113,112,98,96,110,54,71,32
100,14,110,113,109,98,14,96,98,20,101,99,98,97,110,112,111,14,66,8,8,8,67,14,14,109,97,21,95,19,112,14,20,96,112,99,54,33,30,43
20,97,20,20,20,98,20,108,20,20,110,112,20,113,20,96,111,97,101,108,97,97,98,108,101,101,14,66,8,67,99,14,97,20,99,100,66,9,95,95
14,112,14,99,108,20,20,14,14,111,97,100,20,99,111,98,101,111,99,20,100,20,14,101,101,14,14,20,98,99,20,97,100,14,98,96,100,66,9,95
32,32,55,99,108,20,96,110,96,97,20,113,108,101,108,111,101,96,101,108,111,14,100,20,100,14,98,113,20,99,14,101,20,111,20,101,14,14,66,8
45,95,31,71,55,20,101,100,110,112,111,111,98,14,101,96,99,108,98,100,14,14,110,20,101,100,111,108,20,112,14,98,109,20,20,14,14,20,14,20
45,95,95,30,19,108,99,20,101,108,99,99,101,98,14,98,101,100,101,99,108,14,112,54,71,71,32,55,14,20,20,14,14,14,108,14,14,20,14,96
95,95,7,8,67,112,113,111,96,108,112,20,14,108,14,101,101,99,20,100,113,100,54,33,30,68,57,31,55,96,99,113,99,97,108,110,98,20,100,98
45,95,19,14,14,96,14,14,108,98,54,32,71,55,14,110,20,110,54,32,55,109,66,9,95,95,30,95,19,14,109,97,98,20,99,97,109,99,100,101
45,95,31,32,32,55,14,14,99,14,21,95,30,19,99,96,14,54,33,95,31,55,112,66,8,9,95,7,67,100,20,14,20,96,14,111,14,108,110,109
57,95,95,95,43,70,14,96,108,20,66,9,95,19,20,14,14,66,9,95,95,31,55,14,20,66,8,67,97,20,112,112,113,110,109,99,97,110,20,108
30,95,7,8,8,67,111,14,14,20,112,66,8,67,14,100,113,14,66,8,9,6,19,96,14,20,101,111,110,108,112,54,71,55,113,101,113,97,113,20
95,95,19,113,14,99,100,20,97,14,96,20,110,20,109,100,98,101,100,14,59,78,67,97,20,14,99,20,99,14,54,33,30,19,20,14,111,113,96,20
95,95,31,55,100,111,20,111,14,20,108,14,14,14,109,20,101,100,54,32,33,31,32,55,113,20,97,112,20,111,21,95,7,67,101,101,109,111,110,97
9,6,95,31,55,98,99,98,100,14,97,14,97,100,96,20,97,14,21,95,95,95,7,67,97,14,100,96,96,110,66,8,67,98,20,98,14,112,111,20
66,58,8,8,67,109,14,20,99,110,14,14,97,14,109,97,54,32,33,95,7,8,67,14,98,113,99,98,108,98,20,100,109,111,96,110,54,32,32,71
54,32,55,110,14,54,32,32,55,20,113,14,108,111,113,99,66,9,7,8,67,109,20,98,109,14,101,14,101,96,20,20,14,20,20,98,21,95,95,30
21,95,19,109,14,21,95,95,31,32,55,97,20,111,20,101,99,66,67,14,113,100,110,111,20,101,20,14,109,14,111,14,99,113,101,108,66,9,95,95
66,8,67,100,20,66,8,8,8,8,67,14,112,20,14,111,14,109,110,20,97,20,14,111,14,14,14,109,14,111,20,14,109,20,111,20,20,66,9,95
14,112,14,96,54,55,14,113,111,101,14,20,111,20,14,100,14,99,98,113,96,20,14,97,99,14,14,20,113,14,113,14,96,14,101,111,14,98,66,9
98,97,14,54,33,19,14,54,32,32,55,14,20,112,112,109,20,14,111,111,14,14,96,100,14,14,54,32,55,20,14,14,97,113,14,110,20,14,98,66
108,14,54,33,7,67,100,66,8,8,67,110,54,32,55,111,20,14,99,111,109,111,14,100,14,98,21,95,31,32,55,113,100,108,14,20,54,32,32,55
32,32,33,7,67,14,112,96,98,108,113,110,66,9,31,55,111,110,113,14,20,99,14,98,14,20,66,9,95,7,67,97,14,14,100,14,66,9,95,31
95,95,7,67,54,32,32,32,32,32,32,32,55,66,9,31,32,55,20,54,32,32,55,20,20,111,96,66,8,67,110,20,14,14,112,20,99,66,8,8
8,8,67,54,33,95,7,8,8,9,95,43,70,14,66,9,95,31,32,33,95,7,67,97,101,108,20,111,20,97,108,100,112,101,111,14,98,14,20,99
98,112,54,33,95,95,19,14,20,66,8,9,31,32,55,21,95,95,95,95,7,67,98,109,20,110,97,100,111,20,112,14,112,112,98,99,20,14,54,32
96,14,21,95,95,43,70,98,109,14,97,21,95,7,67,66,8,8,8,8,67,101,54,32,32,32,55,20,14,14,108,112,14,110,20,96,20,108,21,95
20,14,66,8,9,95,19,98,20,14,99,66,8,67,101,14,20,112,111,97,111,54,33,95,7,8,67,14,109,20,98,112,99,112,97,20,98,54,33,95
98,99,111,101,66,8,67,14,14,20,109,100,100,14,109,14,20,20,110,20,54,33,7,8,67,20,110,108,111,97,97,97,97,97,97,111,96,21,95,95
108,97,20,97,96,97,96,20,20,101,20,14,99,14,97,20,109,108,14,97,66,8,67,111,14,14,14,96,20,97,97,97,97,97,97,111,108,21,95,95
100,101,20,101,110,108,96,111,101,101,97,20,112,113,20,98,108,20,14,20,112,97,109,96,98,14,101,14,101,97,97,97,97,97,97,113,96,59,45,95
